1111111111111111
10000000000000001
 10p00000000000001
  10000000000000001
   10000000000000001
    10000000000000001          3
     1111111111111001         3w3
                 1001         101
                  1001        101
                   1001       101
                    1001111111101
                     100000000001
                      10011111111
                       1001
                        1001
                         1001
                          2002
                           22
