11111111111111111111111
10000000000000000000001
 10p000000000000000001
  1000000000000000001
   10000000000000001
    100000000000001
     1000000000001
      10000000001
       100000001
        1000001
         10001
          1w1
           1
