111111111111111111111111111111111
100000000000000000000000000000001
1000000000000000000000000000000001
10000000000000000000000000000000001
100000000000000000000000000000000001
10000000000p00000000000000000000000w1
1111111111111111111111111111111111111
